0 0 0 0 0 0 0 0 0 0 0 0 0 0 0 0 0 0 0 0 0 0 0
0 1 5 1 0 0 0 0 0 0 0 1 1 1 1 1 4 1 1 1 1 1 0
0 1 1 1 0 0 0 0 0 0 0 1 0 0 0 0 0 0 0 1 6 1 0
0 1 4 3 1 1 0 4 1 1 0 4 0 1 1 1 0 0 0 4 5 1 0
1 1 1 1 0 1 0 1 1 1 0 1 0 1 1 1 0 0 0 1 4 1 0
0 6 6 1 0 1 0 1 6 1 0 1 1 1 2 1 0 0 0 4 1 1 0
0 0 0 0 0 1 0 1 1 1 0 1 0 1 1 1 0 0 0 0 0 1 0
0 0 0 0 0 1 0 1 5 3 4 1 0 1 2 1 0 1 1 1 1 1 0
0 0 0 0 0 1 0 1 4 1 0 0 0 1 1 1 0 2 0 0 0 0 0
0 1 4 1 1 1 0 1 1 1 0 1 0 1 1 1 0 1 1 1 1 1 0
0 4 1 1 0 0 0 0 0 0 0 0 0 0 0 0 0 0 0 1 1 1 0
1 1 6 1 0 4 1 1 0 1 2 1 0 1 1 3 4 1 0 1 4 1 0
1 1 1 1 0 1 6 1 0 1 0 1 0 1 0 1 1 1 0 1 6 1 0
1 1 5 1 0 4 4 1 0 1 0 1 1 1 0 1 6 1 0 1 4 4 0
0 1 1 4 0 4 1 1 0 1 0 0 0 0 0 1 1 1 0 1 5 1 0
0 4 1 1 0 1 6 1 0 4 1 1 0 0 0 1 4 1 1 1 1 4 0
0 1 1 1 0 1 1 3 1 1 0 1 0 0 0 1 1 1 0 1 1 1 0
0 1 6 1 0 4 1 1 0 0 0 1 0 0 0 1 1 1 0 1 2 1 0
0 1 1 1 0 0 0 0 0 0 0 4 0 0 0 0 0 0 0 1 1 1 0
0 4 1 3 1 1 0 4 1 1 0 1 0 4 4 4 0 1 1 1 1 1 0
0 0 0 0 0 1 0 4 4 1 0 1 0 1 1 1 0 1 0 0 0 0 0
0 0 0 0 0 4 0 1 5 1 0 1 0 1 4 1 0 2 0 0 0 0 0
0 0 0 0 0 1 0 1 1 1 0 1 0 1 6 1 0 1 0 0 0 0 0
0 1 4 4 0 1 0 1 6 1 0 4 0 1 5 1 0 1 1 1 1 1 0
0 1 6 1 0 1 0 1 1 1 0 1 0 1 4 1 0 0 0 1 5 1 0
0 1 1 3 1 4 0 1 1 1 0 1 0 1 1 1 0 0 0 1 6 1 0
0 1 5 1 0 1 0 0 1 0 0 1 0 1 1 1 0 0 0 1 5 1 0
0 1 1 1 0 1 1 1 4 1 1 4 0 0 0 1 1 2 1 1 1 4 0
0 0 0 0 0 0 0 0 0 0 0 0 0 0 0 0 0 0 0 0 0 0 0