XXXXXXXXXXXXXXXXXXXXXXX
X...................XXX
X...................XXX
X...................XXX
XXX.................XXX
XXX.................XXX
X...................XXX
X...........1.......XXX
X........2..........XXX
X.B.................XXX
XX.XXXXXXXX.XXXXXX.XXXX
XX.XXXXXXXX.XXXXXX.XXXX
XX.XXXXXXXX.XXXXXX.XXXX
XX.XXXXXXXXBXXXXXXBXXXX
XXXXXXXXXXXXXXXXXXXXXXX