XXXXXXXXXXXXXXXXXXXXXXX
X.......XXXXXXXX....XXX
X1.............X....XXX
X.......XXXXX..X....XXX
XXXXXXXXXXXXX..X....XXX
XXXXXXX...........XXXXX
XXXXXXX...........XXXXX
XXXXXXXXX........XXXXXX
XXXXXXXXXXX....XXXXXXXX
XXXXXXXXXXX....XXXXXXXX
XXXXXXXXXXX....XXXXXXX
XXXXXXXXXXX....XXXXXXXX
XXXXXXXXXXX....XXXXXXXX
XXXXXXXXXXX....XXXXXXXX
XXXXXXXXXXX....XXXXXXXX
XXXXXXXXXXX....XXXXXXXX
XXXXXXXXXXX....XXXXXXXX
XXXXXXXXXXX....XXXXXXXX
XXXXXXXXXXX....XXXXXXXX
XXXXXXXXXXXX.XXXXXXXXXX
XXXXXXXXXXXX.XXXXXXXXXX
XXXXXXXXXXXX.XXXXXXXXXX
XXXXXXXXXX...XXXXXXXXXX
XXXXXXXXXX.XXXXXXXXXXXX
XXXXXXXXXX.XXXXXXXXXXXX
XXXXXXXX.....XXXXXXXXXX
XXXXXXXX.....XXXXXXXXXX
XXXXXXXX..B..XXXXXXXX
XXXXXXXXXXXXXXXXXXXXXXX